R 180 180

NO pics/redbrick.xpm
SO pics/eagle.xpm
WE pics/mossy.xpm
EA pics/bluestone.xpm

F 0,0,0
C 0,0,0

111111111111111111111111
100000000000000000000001
100000000000000000000001
100000000000000000000001
111111111100000001111111
100000111110000101010001
100000100010000000000001
100000101010000100010001
100000100010000000000001
100000110110000101010001
100000000000000000000001
100000000000000000000001
100000000000000000000001
100000000000000000000001
100000000000000000000001
100000000000000000000001
100000000000000000000001
111111111000000100000001
110100001000000000000001
110000101000000000000001
110100001000000010000001
110111111000000100000001
110000000000001000000001
111111111000010000000001
111111111111111111111111