R 180 180

NO pics/redbrick.xpm
SO pics/eagle.xpm
WE pics/mossy.xpm
EA pics/bluestone.xpm

F 0,0,0
C 0,0,0

11111
1
1