R 1920 1080

NO pics/redbrick.xpm
SO pics/eagle.xpm
WE pics/mossy.xpm
EA pics/bluestone.xpm
S pics/barrel.xpm

F 0,0,0
C 0,0,0

111                  1
1001111111111111111111111
100000000000000000000001
100000000000000000000001
100000000000000000000001
111111111100000001111111
100000111110000101010001
100000100010000000000001
1000001010100001000100011111111111111
1000001000100000000000000000000000001
10000011011000010101000111111111111111111
100000000000000000000001
111111000000000000000001
     1000000000000000001
111111200000000000000001
1000000000N0000000000001       
100000000000000000000001
100000000000000000000001
111111111000000100000001
110100001000000000000001
11000010100000000000000111111111111111111
11010000100000001000000000001000000100001
11011111100000010000000110111010100110101
10000000000000100000000110101011010100101
10111111100001000000000110000000010001001
10111111111111111111111111111111111111101
10000000000000000000000000000000000000001
11111111111111111111111111111111111111111
 11111111111 11111