R 480 480

NO pics/redbrick.xpm
SO pics/eagle.xpm
WE pics/mossy.xpm
EA pics/bluestone.xpm

F 0,0,0
C 0,0,0

111111111111111111111111
100000000000000000000001
100000000000000000000001
100000000000000000000001
100000222220000303030001
100000200020000000000001
100000203020000300030001
100000200020000000000001
100000220220000303030001
100000000000000000000001
100000000000000000000001
100000000000000000000001
100000000000000000000001
100000000000000000000001
100000000000000000000001
100000000000000000000001
144444444000000100000001
140400004000000000000001
140000504000000000000001
140400004000000010000001
140444444000000100000001
140000000000001000000001
144444444000010000000001
111111111111111111111111